{
  "stageName": "Forest of Doom",
  "stageID": 1,
  "difficulty": 1,
  "coins": 600,
  "spawnPosition": [
    { "x" : 60, "y": 260},
    { "x" : 60, "y": 300}
  ],
  "waves": [
    {
      "wave": 1,
      "enemies": [
        { "type": "Monster01", "count": 10, "spawnInterval": 2, "spawnIndex": 0 },
        { "type": "Monster02", "count": 5, "spawnInterval": 4, "spawnIndex": 1 }
      ]
    },
    {
      "wave": 2,
      "enemies": [
        { "type": "Monster01", "count": 15, "spawnInterval": 1.5, "spawnIndex": 0 },
        { "type": "Monster02", "count": 8, "spawnInterval": 3, "spawnIndex": 1 },
        { "type": "Monster03", "count": 2, "spawnInterval": 6, "spawnIndex": 1 }
      ]
    }
  ],
  "map": {
    "path": [
      [
        { "x": 60 , "y": 260 },
        { "x": 240, "y": 260 },
        { "x": 260, "y": 210 },
        { "x": 270, "y": 195 },
        { "x": 290, "y": 178 },
        { "x": 300, "y": 170 },
        { "x": 310, "y": 164 },
        { "x": 320, "y": 158 },
        { "x": 330, "y": 154 },
        { "x": 340, "y": 149 },
        { "x": 350, "y": 146 },
        { "x": 360, "y": 142 },
        { "x": 370, "y": 140 },
        { "x": 380, "y": 137 },
        { "x": 390, "y": 135 },
        { "x": 400, "y": 133 },
        { "x": 410, "y": 132 },
        { "x": 420, "y": 131 },
        { "x": 430, "y": 130 },
        { "x": 440, "y": 130 },
        { "x": 450, "y": 130 },
        { "x": 460, "y": 130 },
        { "x": 470, "y": 130 },
        { "x": 480, "y": 131 },
        { "x": 490, "y": 132 },
        { "x": 500, "y": 133 },
        { "x": 510, "y": 135 },
        { "x": 520, "y": 137 },
        { "x": 530, "y": 140 },
        { "x": 540, "y": 142 },
        { "x": 550, "y": 146 },
        { "x": 560, "y": 149 },
        { "x": 570, "y": 154 },
        { "x": 580, "y": 158 },
        { "x": 590, "y": 164 },
        { "x": 600, "y": 170 },
        { "x": 610, "y": 178 },
        { "x": 620, "y": 186 },
        { "x": 630, "y": 197 },
        { "x": 640, "y": 212 },
        { "x": 650, "y": 260 },
        { "x": 950, "y": 260 }
      ],
      [
        { "x": 100, "y": 300 },
        { "x": 250, "y": 300 },
        { "x": 260, "y": 337 },
        { "x": 270, "y": 352 },
        { "x": 280, "y": 363 },
        { "x": 290, "y": 372 },
        { "x": 300, "y": 379 },
        { "x": 310, "y": 385 },
        { "x": 320, "y": 391 },
        { "x": 330, "y": 396 },
        { "x": 340, "y": 400 },
        { "x": 350, "y": 403 },
        { "x": 360, "y": 407 },
        { "x": 370, "y": 409 },
        { "x": 380, "y": 412 },
        { "x": 390, "y": 414 },
        { "x": 400, "y": 416 },
        { "x": 410, "y": 417 },
        { "x": 420, "y": 418 },
        { "x": 430, "y": 419 },
        { "x": 440, "y": 419 },
        { "x": 450, "y": 420 },
        { "x": 460, "y": 419 },
        { "x": 470, "y": 419 },
        { "x": 480, "y": 418 },
        { "x": 490, "y": 417 },
        { "x": 500, "y": 416 },
        { "x": 510, "y": 414 },
        { "x": 520, "y": 412 },
        { "x": 530, "y": 409 },
        { "x": 540, "y": 407 },
        { "x": 550, "y": 403 },
        { "x": 560, "y": 400 },
        { "x": 570, "y": 396 },
        { "x": 580, "y": 391 },
        { "x": 590, "y": 385 },
        { "x": 600, "y": 379 },
        { "x": 610, "y": 372 },
        { "x": 620, "y": 363 },
        { "x": 630, "y": 352 },
        { "x": 640, "y": 337 },
        { "x": 650, "y": 300 },
        { "x": 950, "y": 300 }
      ]
    ],
    "towerSpots": [
      { "x": 1, "y": 4 },
      { "x": 3, "y": 5 },
      { "x": 6, "y": 2 }
    ]
  }
}
